original	simplification	label
One side of the armed conflicts is composed mainly of the Sudanese military and the Janjaweed, a Sudanese militia group recruited mostly from the Afro-Arab Abbala tribes of the northern Rizeigat region in Sudan.	Modern African history has been rife with revolutions and wars as well as the growth of modern African economies and democratization across the continent.	0.0
Jeddah is the principal gateway to Mecca, Islam's holiest city, which able-bodied Muslims are required to visit at least once in their lifetime.	"The term ""union council"" may be used for localities that are part of cities."	0.0
The Great Dark Spot is thought to represent a hole in the methane cloud deck of Neptune.	Links with poverty and crime Those who are functionally illiterate may be subject to social intimidation, health risks, stress, low income, and other pitfalls associated with their reading and writing deficits.	0.0
His next work, Saturday, follows an especially eventful day in the life of a successful neurosurgeon.	A console manufacturer is a company that manufactures and distributes video game consoles.	0.0
The tarantula, the trickster character, spun a black cord and, attaching it to the ball, crawled away fast to the east, pulling on the cord with all his strength.	On the 15 November 2003 a Sprinter train travelling to Ballarat was derailed between Ballan and Gordon injuring 61 people when it hit a stationary car on a country railway crossing.	0.0
There he died six weeks later, on 13 January 888.	In practice, however, the definition means that high-precision realizations of the second should compensate for the effects of the ambient temperature (black-body radiation) within which atomic clocks operate, and extrapolate accordingly to the value of the second at a temperature of absolute zero.	0.0
They are culturally akin to the coastal peoples of Papua New Guinea.	In October 1983, the Grameen Bank Project was transformed into an independent bank by government legislation.	0.0
Since 2000, the recipient of the Kate Greenaway Medal has also been presented with the Colin Mears Award to the value of £5000.	It was launched on 7 December 1998, and is available on digital television via satellite, cable, IPTV and terrestrial (Freeview) platforms.	0.0
Following the drummers are dancers, who often play the sogo (a tiny drum that makes almost no sound) and tend to have more elaborate — even acrobatic — choreography.	Finished by AD 8, possibly published posthumously.	0.0
The spacecraft consists of two main elements: the NASA Cassini orbiter, named after the Italian-French astronomer Giovanni Domenico Cassini, and the ESA Huygens probe, named after the Dutch astronomer, mathematician and physicist Christiaan Huygens.	The bank then lends these deposits to borrowers.	0.0
"Alessandro (""Sandro"") Mazzola (born 8 November 1942) is an Italian former football player."	The organic matter in soil derives from plants and animals.	0.0
It was originally thought that the debris thrown up by the collision filled in the smaller craters.	"Cognition is the scientific term for ""the process of thought""."	0.0
Graham attended Wheaton College from 1939 to 1943, when he graduated with a BA in anthropology.	History The name Glinde was first mentioned in a document dated from March 25 1229.	0.0
However, the BZÖ differs a bit in comparison to the Freedom Party, as is in favor of a referendum about the Lisbon Treaty but against an EU-Withdrawal.	Schneier designed Blowfish as a general-purpose algorithm, intended as a replacement for the aging DES and free of the problems and constraints associated with other algorithms.	0.0
Many species had vanished by the end of the nineteenth century, with European settlement.	Artifacts at the museum include military aircraft: a Sopwith Triplane from the First World War and an Avro Lancaster from the Second World War.	0.0
In 1987 Wexler was inducted into the Rock and Roll Hall of Fame.	A common element in most conceptions of piety is humility.	0.0
In its pure form, dextromethorphan occurs as a white powder.	Since 1987, the heavy rail passenger Mass Rapid Transit (MRT) metro system has been in operation.	0.0
Admission to Tsinghua is extremely competitive.	FIFA's supreme body is the FIFA Congress, an assembly made up of representatives from each affiliated member association.	0.0
Today NRC is organised as an independent, private foundation.	Name The band came up with the name by flicking through the Bible and picking out a random word.	0.0
It is situated at the coast of the Baltic Sea, where it encloses the city of Stralsund.	In common law legal systems, a precedent or authority is a legal case establishing a principle or rule that a court or other judicial body utilizes when deciding subsequent cases with similar issues or facts.	0.0
"He was also named 1982 ""Sportsman of the Year"" by Sports Illustrated."	Cave himself often contributed pieces to the Magazine under the pen name of Sylvanus Urban.	0.0
Fives is a British sport believed to derive from the same origins as many racquet sports.	A variation of the Mai style of Japanese dance is the Kyomai or Kyoto Style Dance.	0.0
For example, King Bhumibol was born on Monday, so on his birthday throughout Thailand will be decorated with yellow color.	The Beatles famously included his face on the cover of Sgt. Pepper's Lonely Hearts Club Band (Guy and Llewelyn-Jones 2004, 111).	0.0
Both names became defunct in 2007 when they were merged into The National Museum of Scotland.	Subsequently, in February 1941, 600 Jews were sent to Buchenwald and Mauthausen concentration camps.	0.0
Nevertheless, Tagore emulated numerous styles, including craftwork from northern New Ireland, Haida carvings from the west coast of Canada (British Columbia), and woodcuts by Max Pechstein.	Tropical Storm Ana was the only tropical cyclone on record in the Atlantic basin during the month of April.	0.0
On October 14, 1960, Presidential candidate John F. Kennedy proposed the concept of what became the Peace Corps on the steps of Michigan Union.	It is not one of the five Nobel Prizes established by the will of Alfred Nobel in 1895.	0.0
She performed for President Reagan in 1988's Great Performances at the White House series, which aired on the Public Broadcasting Service.	Her death from leukaemia in 1998 was a shock to the nation and her family.	0.0
Perry Saturn (with Terri) defeated Eddie Guerrero (with Chyna) to win the WWF European Championship (8:10) Saturn pinned Guerrero after a Diving elbow drop.	Working extensively with the BBC, Ross has presented The Film programme since 1997, his own chat show, Friday Night with Jonathan Ross since 2001, and a radio show on BBC Radio 2 beginning in 1999.	0.0
She remained in the United States until 1927 when she and her husband returned to France.	The museum and Pearson Field, along with the Fort Vancouver National Historic Site, are part of the Vancouver National Historic Reserve.	0.0
Despina was discovered in late July, 1989 from the images taken by the Voyager 2 probe.	Their religion is predominantly Roman Catholic.	0.0
The first Italian Grand Prix motor racing championship took place on 4 September 1921 at Brescia.	In 1963, Haile Selassie presided over the establishment of the Organisation of African Unity, with the new organization establishing its headquarters in Addis Ababa.	0.0
He also completed two collections of short stories entitled The Ribbajack & Other Curious Yarns and Seven Strange and Ghostly Tales.	He met his wife, dancer Michelle McSween, when the pair starred in the stage musical Oh, What a Night in 1999.	0.0
At the Voyager 2 images Ophelia appears as an elongated object, the major axis pointing towards Uranus.	In 1871 the fortification received an additional barracks.	0.0
The British decided to eliminate him and take the land by force.	It was a deliberate pursuit of simplicity and economy for the Disney studio, and is now generally regarded as a classic of animation.	0.0
Some towns on the Eyre Highway in the south-east corner of Western Australia, between the South Australian border almost as far as Caiguna, do not follow official Western Australian time.	Stallman pioneered the concept of copyleft and is the main author of several copyleft licenses including the GNU General Public License, the most widely used free software license.	0.0
In architectural decoration Small pieces of colored and iridescent shell have been used to create mosaics and inlays, which have been used to decorate walls, furniture and boxes.	In the Middle Ages the region profited from the vicinity of the wealthy Hanseatic city of Rostock.	0.0
The other incorporated cities on the Palos Verdes Peninsula include Rancho Palos Verdes, Rolling Hills Estates and Rolling Hills.	The show followed the lives of a group of teenagers living in the upscale, star-studded community of Beverly Hills, California and attending the fictitious West Beverly High School and, subsequently, the fictitious California University after graduation.	0.0
Fearing that Drek will destroy the galaxy, Clank asks Ratchet to help him find the famous superhero Captain Qwark, in an effort to stop Drek.	Howell County is a county located in South Central Missouri in the United States.	0.0
It is not actually a true louse.	Lisa Donovan (born June 11, 1981) is an American actress and writer.	0.0
He advocates applying a user-centered design process in product development cycles and also works towards popularizing interaction design as a mainstream discipline.	It is one of the most historic motor racing circuits in the world.	0.0
It is theoretically possible that the other editors who may have reported you, and the administrator who blocked you, are part of a conspiracy against someone half a world away they've never met in person.	The Big Mac PPP exchange rate between two countries is obtained by dividing the price of a Big Mac in one country (in its currency) by the price of a Big Mac in another country (in its currency).	0.0
Working Group I: Assesses scientific aspects of the climate system and climate change.	Chess boxing fights have been organized since early 2003.	0.0
The island chain forms part of the Hebrides, separated from the Scottish mainland and from the Inner Hebrides by the stormy waters of the Minch, the Little Minch and the Sea of the Hebrides.	Psyche appears to be a genuine case of an exposed metallic core from a larger differentiated parent body.	0.0
Orton and his wife welcomed Alanna Marie Orton on July 12, 2008.	When animals or people freerun, experiments can be done to see what sort of signals, known as zeitgeber, are effective in entrainment.	0.0
Formal minor planet designations are number-name combinations overseen by the Minor Planet Center, a branch of the IAU.	The International Union for Conservation of Nature and Natural Resources (IUCN) is an international organization dedicated to natural resource conservation.	0.0
By early on September 30, wind shear began to dramatically increase and a weakening trend began.	However, the council was delayed until 1545, and convened right before Luther's death.	0.0
Each entry has a datum (a nugget of data) which is a copy of the datum in some backing store.	He attended the General Theological Seminary and earned his BA in theology and MA from Oriel College, Oxford University (1962, 1966).	0.0
As a result, although many mosques will not enforce violations, both men and women when attending a mosque must adhere to these guidelines.	During the early 1960s, Love first crossed paths with Jim Henson through Don Sahlin, who urged him to meet with Henson.	0.0
Mariel of Redwall is a fantasy novel by Brian Jacques, published in 1991.	To sponsor something is to support an event, activity, person, or organization financially or through the provision of products or services.	0.0
Ryan Prosser (born 10 July, 1988) is a professional rugby union player for Bristol Rugby in the Guinness Premiership.	During and after the Thirty Years' War, Soest suffered a tremendous loss of both population and influence; at the lowest point in 1756 it had only 3,600 citizens.	0.0
Like previous assessment reports, it consists of four reports, three of them from its working groups.	2016 (MMXVI) will be a leap year starting on Friday of the Gregorian calendar.	0.0
Their granddaughter Hélène Langevin-Joliot is a professor of nuclear physics at the University of Paris, and their grandson Pierre Joliot, who was named after Pierre Curie, is a noted biochemist.	Hurricane Epsilon was only the sixth ever Atlantic hurricane recorded in December.	0.0
This stamp remained the standard letter stamp for the remainder of Victoria's reign, and vast quantities were printed.	Pedro involves the title character, a small airplane from Chile, engaging in his very first flight to pick up air mail from Mendoza, with near disastrous results.	0.0
The International Fight League was an American mixed martial arts (MMA) promotion billed as the world's first MMA league.	As the last album of the Scandinavian vocal music series, Pohjola produced a tribute to the Finnish legendary tango composer, Toivo Kärki on the album, Leivonen lumimyrskyssä (A Lark in a Snowstorm) (2006).	0.0
Giardia lamblia (synonymous with Lamblia intestinalis and Giardia duodenalis) is a flagellated protozoan parasite that colonises and reproduces in the small intestine, causing giardiasis.	A small amount of matcha is placed into the bowl, traditionally using a bamboo scoop called a chashaku, then a modicum of hot (not boiling) water is added.	0.0
"Aside from this, Cameron has often worked in Christian-themed productions, among them the post-Rapture films Left Behind: The Movie, Left Behind II: Tribulation Force, and Left Behind: World at War, in which he plays Cameron ""Buck"" Williams."	Colin Powell, a long time advocate, has recommended a simple moment of silence at the start of each school day.	0.0
"This was the area east of the mouth of the Vistula River, later sometimes called ""Prussia proper""."	As of 2007, a maximum of four players can be inducted in one year but the greatest number of players ever inducted in a year was 27, in 1962.	0.0
After graduation he returned to Yerevan to teach at the local Conservatory and later he was appointed artistic director of the Armenian Philarmonic Orchestra.	"Spurgeon (1911), p. 565 ""It is called a"" book "", as it is usually represented with pages, although it can be shown on a single page or banner."	0.0
The story of Christmas is based on the biblical accounts given in the Gospel of Matthew, namely - and the Gospel of Luke, specifically -.	As a result of Selene being conflated with Artemis, later writers sometimes referred to Selene as a daughter of Zeus, like Artemis, or of Pallas the Titan.	0.0
Weelkes was later to find himself in trouble with the Chichester Cathedral authorities for his heavy drinking and immoderate behaviour.	Hurricane Lane was the strongest Pacific hurricane to make landfall in Mexico since Hurricane Kenna of 2002.	0.0
So far the 'celebrity' episodes have included Vic Reeves, Nancy Sorrell, Gaby Roslin, Scott Mills, Mark Chapman, Simon Gregson, Sue Cleaver, Carol Thatcher, Paul O'Grady and Lee Ryan.	This cemented public support for the gang especially in northeast Victoria.	0.0
It was discovered by Stephen P. Synnott in images from the Voyager 1 space probe taken on March 5, 1979 while orbiting around Jupiter.	Robert Leroy Johnson (May 8, 1911 – August 16, 1938) was an American blues musician, among the most famous of Delta blues musicians.	0.0
Gomaespuma was a Spanish radio show, hosted by Juan Luis Cano and Guillermo Fesser.	Asia The last Western Satrap, Rudrasimha III, is defeated by the Guptas.	0.0
On 16 June 2009, the official release date of The Resistance was announced on the band's website.	After the release of a promotional single, Glory to the Brave was released throughout Europe.	0.0
He is also a member of another Jungiery boyband 183 Club.	These Eid prayers are supposed to be offered in large groups, and so larger mosques will normally host them for their congregants as well as the congregants of smaller local mosques.	0.0
The Apostolic Tradition, attributed to the theologian Hippolytus, attests the singing of Hallel psalms with Alleluia as the refrain in early Christian agape feasts.	The possibility remained that liquid ethane and methane might be found on Titan's poles, where it was expected to be abundant and stable.	0.0
In return, Rollo swore fealty to Charles, converted to Christianity, and undertook to defend the northern region of France against the incursions of other Viking groups.	Medieval philosophy In Medieval Europe, dialectics (also called logic) was one of the three original liberal arts collectively known as the trivium (the others were rhetoric and grammar).	0.0
It is derived from Voice of America (VoA) Special English.	The account of Ninigi no Mikoto being sent to earth appears in the Nihon Shoki.	0.0
Disney received a full-size Oscar statuette and seven miniature ones, presented to him by 10-year-old child actress Shirley Temple.	While collaborating with Mylène Farmer and Laurent Boutonnat, Alizée released two albums — both of which were hits inside and outside of France.	0.0
It was the first asteroid to be discovered by a spacecraft.	In addition, the station provides live coverage of the non-final rounds of the other Grand Slam tournaments.	0.0
Hinterrhein is an administrative district in the canton of Graubünden, Switzerland.	He commanded the 25th Punjabis in India and Hong Kong and was promoted to Lieutenant-Colonel in 1910.	0.0
It continues as the Bohemian Switzerland in the Czech Republic.	"Law of Independent Assortment (The ""Second Law"") The Law of Independent Assortment, also known as ""Inheritance Law"", states that alleles of different genes assort independently of one another during gamete formation."	0.0
This leads to consumer confusion when 220 (1,048,576) bytes is referenced as 1 MB (megabyte) instead of 1 MiB.	Mark Schatz has played bass regularly with the group since 2003.	0.0
The incident has been the subject of numerous reports as to ethics in scholarship.	In other media Aquaman has appeared in multiple cartoon series, as well as a live action version appearing in the TV series Smallville.	0.0
They are castrated so that the animal may be more docile or may put on weight more quickly.	In 1845 it joined the United States as the 28th state.	0.0
"Seventh sons have strong ""knacks"" (specific magical abilities), and seventh sons of seventh sons are both extraordinarily rare and powerful."	Italians know it for hosting a maximum-security prison (1858 - 1998) holding especially dangerous Mafia criminals.	0.0
Benchmarking conducted by PassMark Software highlights the 2009 version's 52 second install time, 32 second scan time, and 7 MB memory utilization.	The NHL instituted the icing rule on March 13, 1939.	0.0
Volterra is a town in the Tuscany region of Italy.	Cale's Story: the adventures of Cale, ending with the beginning of the film.	0.0
Historically, the sensations of itch and pain have not been considered to be independent of each other until recently, where it was found that itch has several features in common with pain, but exhibits notable differences.	Electra welcomes the idea of going to Argos with Idamante.	0.0
The tongue is sticky because of the presence of glycoprotein-rich mucous, which both lubricates movement in and out of the snout and helps to catch ants and termites, which adhere to it.	While not lethal, consuming this mushroom leads to very severe cramps, vomiting, and diarrhea.	0.0
The same tram had derailed on 30 May 2006 at Starr Gate loop during previous trials.	After initially being posted to the 1st Battalion, in March, 1916 he was transferred to the 53rd Battalion, which was part of the 5th Division, when the Australian Imperial Force was reinforced with fresh recruits from Australia.	0.0
There are statues of Sir Alf Ramsey and Sir Bobby Robson, both former Ipswich Town and England managers, outside the ground.	Holly Springs is a town in Wake County, North Carolina, United States.	0.0
Take the square root of the variance.	He was nominated a Cardinal Priest, of the title of Santa Maria Nuova, on 18 February 1946.	0.0
Volunteers provided food, blankets, water, children's toys, massages, and a live rock band performance for those at the stadium.	The Saugor and Nerbudda Territories were attached to the North-Western Provinces, which included the British Dominions in the southern portion of present-day Uttar Pradesh state.	0.0
Vouvray-sur-Huisne is a commune in the Sarthe department in the region of Pays-de-la-Loire in northwestern France.	It can also be used pejoratively, to refer to a common street beggar who chants holy names, scriptures or verses.	0.0
If there are no strong land use controls, buildings are built along a bypass, converting it into an ordinary town road, and the bypass may eventually become as congested as the local streets it was intended to avoid.	Meanwhile, Big Mama explains to Tod that his friendship with Copper can not continue, as they are natural enemies, but Tod refuses to believe her.	0.0
It is also a starting point for people wanting to explore Cooktown, Cape York Peninsula, and the Atherton Tableland.	Command Module Pilot Stuart Roosa took several hundred seeds on the mission, many of which were germinated on return resulting in the so called Moon trees.	0.0
Bruises often induce pain but are not normally dangerous.	In 911, French King Charles the Simple was able to make an agreement with the Viking warleader Rollo, a chieftain of disputed Norwegian or Danish origins.	0.0
None of the authors, contributors, sponsors, administrators, vandals, or anyone else connected with Wikipedia, in any way whatsoever, can be responsible for your use of the information contained in or linked from these web pages.	The strengthening trend abated early on July 8, due to wind shear, and Bertha rapidly weakened back to a Category 1 hurricane that afternoon.	0.0
George Frideric Handel also served as Kapellmeister for George, Elector of Hanover (who eventually became George I of Great Britain).	It was released on January 21, 2003 and garnered DVDX awards for best animated feature, best director, best editing, and best musical score.	0.0
Their eyes are quite small, and their visual acuity is poor.	It is not clear whether it is only a transient clump of dust, or if there is a solid moonlet at its core.	0.0
They are rivaled as biological materials in toughness only by chitin.	History Vaihingen may date back as far as 799 a. d., but the documents are not clear.	0.0
Oregano is an indispensable ingredient in Greek cuisine.	A night shift is either a group of workers who work during the night, or the period in which they work.	0.0
Tickets can be retailed for National Rail services, the Docklands Light Railway and on Oyster card.	His baptism followed on May 3 in the river Lark, at Isleham.	0.0
These works he produced and published himself, whilst his much larger woodcuts were mostly commissioned work.	"The album was fueled by the single ""Fat Lip"", which reached the top position on the Billboard Modern Rock chart, making it the band's most successful single."	0.0
The historical method comprises the techniques and guidelines by which historians use primary sources and other evidence to research and then to write history.	The Fert group first saw the large effect in multilayers that led to its naming, and first correctly explained the underlying physics.	0.0
The sheer weight of the continental icecap sitting on top of Lake Vostok is believed to contribute to the high oxygen concentration.	"Due to its appearance at burial sites across the globe, the spiral most likely represented the ""life-death-rebirth"" cycle."	0.0
As of 2000, the population was 89,148.	These cone photoreceptors are sensitive to different portions of the visible spectrum.	0.0
Aliteracy (sometimes spelled alliteracy) is the state of being able to read but being uninterested in doing so.	The city has a larger population than the provincial capital, and ranks second in land area.	0.0
Mifepristone is a synthetic steroid compound used as a pharmaceutical.	Fire Salamanders can have a very long lifespan.	0.0
It will then dislodge itself and sink back to the river bed in order to digest its food and wait for its next meal.	History The first mention of the town dates from 1178.	0.0
Furthermore, research has shown children are less likely to report a crime if it involves someone that he or she knows, trusts, and / or cares about.	In June 2008, it was announced that a further four-year deal would commence for the 2010 / 11 season, with the deal worth £125m.	0.0
Today, Landis' father has become a hearty supporter of his son and regards himself as one of Floyd's biggest fans.	According to the study, if all this software had been developed by conventional proprietary means, it would have cost about $(US dollars) to develop in the United States.	0.0
Shortly after attaining Category 4 status, the outer convection of the hurricane became ragged.	Shadow of the Hegemon (2001) is the second novel in the Ender's Shadow series (often called the Bean Quartet) by Orson Scott Card.	0.0
The equilibrium price for a certain type of labor is the wage.	For a person to be inducted to the Hockey Hall of Fame, they must be nominated by an elected 18 - person selection committee which consists of Hockey Hall of Fame members and media personalities.	0.0
Convinced that the grounds were haunted, they decided to publish their findings in a book An Adventure (1911), under the pseudonyms of Elizabeth Morison and Frances Lamont.	Several marsupial herbivores, notably koalas and some possums, are relatively tolerant of it.	0.0
He settled in London, devoting himself chiefly to practical teaching.	However, this list contains substances which may have synthetic origins.	0.0
Brunstad has several fast food restaurants, a cafeteria-style restaurant, coffee bar, and its own grocery store.	Among his published works were Peace, a Lyric Poem (1814); Resignation (1817); The Triumph of Christianity (1819); and The Soldier's Friend (1828).	0.0
He left a detachment of 11,000 troops to garrison the newly conquered region.	In the historiography of Japan, the Edo period from 1590 to 1868 is also sometimes referred to as the early modern period.	0.0
In 1438 Trevi passed under the temporal rule of the Church as part of the legation of Perugia, and thenceforth its history merges first with that of the States of the Church, then (1860) with the united Kingdom of Italy.	Plessur is an administrative district in the canton of Graubünden, Switzerland.	0.0
The depression moved inland on the 20th as a circulation devoid of convection, and dissipated the next day over Brazil, where it caused heavy rains and flooding.	Mexican cinnamon hot chocolate is traditionally served alongside a variety of Mexican pastries known as pan dulce and, as in Spain, churros.	0.0
The New York City Housing Authority Police Department was a law enforcement agency in New York City that existed from 1952 to 1995.	Captive longevity is 20 to 30 years, with rare accounts of over 40 years, Reports of a individual living to 40 years in Philadelphia Zoo.	0.0
The current lineup of the band comprises Flynn (vocals, guitar), Duce (bass), Phil Demmel (guitar), and Dave McClain (drums).	Redwall is a series of fantasy novels by Brian Jacques.	0.0
Advocacy Countries with a minority Muslim population are more likely than Muslim-majority countries of the Greater Middle East to use mosques as a way to promote civic participation.	The Taiwan Strait or Formosa Strait is a 180 - km-wide (111.85 - mile-wide) strait between mainland China and Taiwan.	0.0
The characters are foul-mouthed extensions of their earlier characters Pete and Dud.	The most common symptoms of MI in women include dyspnea, weakness, and fatigue.	0.0
Johan was also the original bassist of the Swedish power metal band HammerFall, but quit before the band ever released a studio album.	As Norma dissipated, moisture from the cyclone was entrapped in a large extratropical low.	0.0
In 1998, Culver ran for Iowa Secretary of State and was victorious.	Local existence Not all Bundesländer have this subdivision; some are directly divided into districts.	0.0
In 1990, Mark Messier took the Hart over Ray Bourque by a margin of two votes, the difference being a single first-place vote.	Very few consumers of bi-porn identify as gay.	0.0
Shade sets the main plot of the novel in motion when he impetuously defies that law, and inadvertently initiates a chain of events that leads to the destruction of his colony's home, forcing their premature migration, and his separation from them.	"The year 1976 saw Punk arrive on what some people perceived to be a stagnant music scene and NME, like other ""specialist"" publications, was slow to cover this new phenomenon."	0.0
The female equivalent is a daughter.	The mountain range forms the border between both countries for 150 kilometers, extending from the western border of Saxony to the Elbe river.	0.0
He was diagnosed with inoperable abdominal cancer in April 1999.	Under President and CEO Reynolds, the park operated until April 13, 2003, when it closed after a prolonged tourism decline following the September 11, 2001 terrorist attacks.	0.0
Prior to the arrival of the storm, the National Park Service closed visitor centers and campgrounds along the Outer Banks.	News reports indicate that the poorer, rural villages were hardest hit.	0.0
The form of chess played is speed chess in which each competitor has a total of twelve minutes for the whole game.	Traditionally, the leader of the National Party serves as Deputy Prime Minister when the Coalition is in government.	0.0
The Amazon Basin is the part of South America drained by the Amazon River and its tributaries.	The volcano culminates at 1,060 metres, and its crater measures roughly 300 metres in diameter.	0.0
The two former presidents were later separately charged with mutiny and treason for their roles in the 1979 coup and the 1980 Gwangju massacre.	The encryption key is trivially related to the decryption key, in that they may be identical or there is a simple transform to go between the two keys.	0.0
Moderate to severe damage extended up the Atlantic coastline and as far inland as West Virginia.	It is not known how much, if any, of this story is true, but historians do know that China was the first civilization to use silk.	0.0
Because the owner tends to be unaware, these computers are metaphorically compared to zombies.	Such storms can feature strong surface winds and severe hail.	0.0
The wave traveled across the Atlantic, and organized into a tropical depression off the northern coast of Haiti on September 13.	In March 2005, Pavarotti underwent neck surgery to repair two vertebrae.	0.0
For example, the stylebook of the Associated Press is updated annually.	Fiorito originally produced foot fetish videos but soon moved on to coprophagia.	0.0
The four canonical texts are the Gospel of Matthew, Gospel of Mark, Gospel of Luke and Gospel of John, probably written between AD 65 and 100 (see also the Gospel according to the Hebrews).	In the a mathematics, a product is the result of multiplying, or an expression that identifies factors to be multiplied.	0.0
Since the end of the 19th century Eschelbronn is well known for its furniture manufacturing industry.	Despite these unfavorable conditions, a curved convective band developed in its northern and western quadrants, and the circulation became better defined.	0.0
The upper half also resembles the coat of arms of the former district Oberbarnim.	The bridge is administered by the Thousand Islands Bridge Authority, an international agency.	0.0
Unlike the clouds on Earth, however, which are composed of crystals of ice, Neptune's cirrus clouds are made up of crystals of frozen methane.	These events were dramatized in the 1977 movie A Bridge Too Far.	0.0
Their participation is limited until they reach legal adulthood.	It was occupied by the Romans with the rest of the surrounding area in the first century BCE.	0.0
Development Stable releases are rare, but there are often Subversion snapshots which are stable enough to use.	This arises when a pawn uses its initial-move option to advance two squares instead of one, and in so doing passes over a square that is attacked by an enemy pawn.	0.0
Finally in 1482 the Order dispatched him to Florence, the ‘ city of his destiny ’.	In remembrance of the old tradition, the Axel Springer press company erected its German headquarters at Kochstraße again, right next to the Berlin Wall.	0.0
In the Soviet years, the Bolsheviks demolished two of Rostov's principal landmarks - St Alexander Nevsky Cathedral (1908) and St George Cathedral in Nakhichevan (1783-1807).	Before the dominance of recorded music, concerts would be the only opportunity one would generally have to hear musicians play.	0.0
He died on May 29, 1518 in Madrid, Spain and was buried in the church of San Benito d'Alcantara.	Writing After Universal Studios acquired the movie rights to Firefly from Fox, Whedon began writing the screenplay.	0.0
This was demonstrated in the Miller-Urey experiment by Stanley L. Miller and Harold C. Urey in 1953.	Before 1,000 Hours was released, the band dropped the name Sweet Children, according to Livermore this was done in order to avoid confusion with another local band Sweet Baby.	0.0
Cogeneration (also combined heat and power, CHP) is the use of a heat engine or a power station to simultaneously generate both electricity and useful heat.	Another of Groundwater's short stories has been adapted into a live theater performance.	0.0
"On occasion the male ""den master"" will also allow a second male into the den; the reason for this is unclear."	Nordraak died in 1866, and Grieg composed a funeral march in his honor.	0.0
A Wikipedia gadget is a JavaScript and / or a CSS snippet that can be enabled simply by checking an option in your Wikipedia preferences.	They are most often cyclonic, that is, associated with a localized low-pressure region within a severe thunderstorm.	0.0
Below are some useful links to facilitate your involvement.	It is found only on Christmas Island, Australia.	0.0
He served as the prime minister of Egypt between 1945 and 1946 and again from 1946 and 1948.	South India is the area encompassing India's states of Andhra Pradesh, Karnataka, Kerala and Tamil Nadu as well as the union territories of Lakshadweep and Pondicherry, occupying 19.31% of area.	0.0
She was left behind (explanations for this vary) when the rest of the Nicoleños were moved to the mainland.	One foam-rubber process has been coined as Foamation by Will Vinton.	0.0
James I appointed him a Gentleman of the Chapel Royal, where he served as an organist from at least 1615 until his death.	Borken is a Kreis (district) in the northwestern part of North Rhine-Westphalia, Germany in the Region Münsterland.	0.0
Chauvin was embarrassed to receive his award and initially indicated that he may not accept it.	Emmen is a municipality and a town in the northeastern Netherlands.	0.0
Later, Esperanto speakers began to see the language and the culture that had grown up around it as ends in themselves, even if Esperanto is never adopted by the United Nations or other international organizations.	The school icon is an eagle symbolizing courage and determination.	0.0
Dry air wrapping around the southern periphery of the cyclone eroded most of the deep convection by early on September 12.	Eureka is a city in Woodford County, Illinois, United States.	0.0
Calvin Baker is an American novelist.	On 28 March 1941, Woolf committed suicide.	0.0
Eva Anna Paula Braun, died Eva Anna Paula Hitler (6 February 1912 – 30 April 1945) was the longtime companion and, for a brief time, wife of Adolf Hitler.	"In early 2003, she released her fourth album titled, ""To Be Continued..."" which was also met with commercial success."	0.0
Each version of the License is given a distinguishing version number.	The Odyssey is an ancient Greek epic poem attributed to Homer.	0.0
Most IRC servers do not require users to register an account but a user will have to set a nickname before being connected.	Later Wales withdrew his support and asked for Essjay's resignation from his positions with Wikipedia and Wikia.	0.0
That same year he also received a mechanics certificate, becoming the youngest certificated airplane mechanic in New York.	This resulted in a vest with vertical stripes of white and navy-blue color.	0.0
SummerSlam (2009) is an upcoming professional wrestling pay-per-view event produced by World Wrestling Entertainment (WWE), which will take place on August 23, 2009 at Staples Center in Los Angeles, California.	Sthenurine forelimbs were long with two extra-long fingers and claws compared with the relatively small, stiff arms of modern macropods.	0.0
Usually portrayed as being bald, with long whiskers, he is said to be an incarnation of the Southern Polestar.	They are a type of reporter gene used in laboratory microbiology, molecular biology, and genetic engineering to indicate the success of a transfection or other procedure meant to introduce foreign DNA into a cell.	0.0
A few animals have chromatic response, changing color in changing environments, either seasonally (ermine, snowshoe hare) or far more rapidly with chromatophores in their integument (the cephalopod family).	Cash is another commodity that may be packaged together with contracts and / or draft picks to complete a trade.	0.0
Val Venis defeated Rikishi in a Steel cage match to retain the WWF Intercontinental Championship (14:10) Venis pinned Rikishi after Tazz hit Rikishi with a TV camera.	The Association pour la taxation des transactions financières pour l'aide aux citoyens (Association for the Taxation of Financial Transactions for the Aid of Citizens, ATTAC) is an activist organization for the establishment of a tax on foreign exchange transactions.	0.0
This closely resembles the Unix philosophy of having multiple programs each doing one thing well and working together over universal interfaces.	It is a commonly stolen street sign.	0.0
He came from a musical family; his mother, LaRue, was an administrative assistant and singer, and his father, Keith Brion, was a band director at Yale.	With little warning, a second earthquake of magnitude 5.1 May 18 triggered a massive collapse of the north face of the mountain.	0.0
The largest populations of Mennonites are in Canada, Democratic Republic of Congo and the United States, but Mennonites can also be found in tight-knit communities in at least 51 countries on six continents or scattered amongst the populace of those countries.	This work was accomplished through the efforts of Martin Evans and Oliver Smithies working on the knockout mice.	0.0
"Naas is a major ""Dublin Suburb"" town, with many people living in Naas and working in Dublin."	Between rounds there is a one minute pause, during which competitors change their gear.	0.0
Acanthopholis's armour consisted of oval plates set almost horizontally into the skin, with spikes protruding from the neck and shoulder area, along the spine.	A. I. Artificial Intelligence One Kubrick project was eventually completed by another director, Steven Spielberg.	0.0
Origin Irmo was chartered on Christmas Eve in 1890 in response to the opening of the Columbia, Newberry and Laurens Railroad.	Males can weigh more than 20 kg and attain a head-body length of 90 cm.	0.0
Conversely, bills proposed by the Law Commission, and consolidation bills, start in the House of Lords.	Before the 2002 election FC Bayern General Manager Uli Hoeneß expressed his support for Stoiber and the CSU.	0.0
In the years before his final release in 1474, when he began preparations for the reconquest of Wallachia, Vlad resided with his new wife in a house in the Hungarian capital.	Power transmission is the movement of energy from its place of generation to a location where it is applied to performing useful work.	0.0
You may add a passage of up to five words as a Front-Cover Text, and a passage of up to 25 words as a Back-Cover Text, to the end of the list of Cover Texts in the Modified Version.	It is the established convention of the scientific community to define the vitreous electrification as positive, and the resinous electrification as negative.	0.0
He is interred in the Restvale Cemetery in Alsip, Illinois.	Year-Round School is the scheduling of educational institutions so that students take class throughout the entire calendar year.	0.0
Bone marrow is the flexible tissue found in the hollow interior of bones.	Annaser Benghazi is a Libyan football club based in Benghazi, Libya.	0.0
Reflection nebulae are usually blue because the scattering is more efficient for blue light than red (this is the same scattering process that gives us blue skies and red sunsets).	"Eventually, this also expanded the realm of ""Just Say No"" to violence, premarital sex, and any other ""vices"" that young people might try."	0.0
Monteux is a commune of the Vaucluse département in southern France, in the area Provence-Alpes-Côte d'Azur.	Metarterioles provide direct communication between arterioles and venules and are important in bypassing the bloodflow through the capillaries.	0.0
MacGruber starts asking for simple objects to make something to defuse the bomb, but he is later distracted by something (usually involving his personal life) that makes him run out of time.	The Arkansas River is a major tributary of the Mississippi River.	0.0
This was substantially complete when Messiaen died, and Yvonne Loriod undertook the final movement's orchestration with advice from George Benjamin.	Two tubes of amphetamines and a further empty tube were found in the rear pocket of his racing jersey.	0.0
Shi'a Muslims consider Karbala to be one of their holiest cities after Mecca, Medina, Jerusalem and Najaf.	Honduras (,) is a republic in Central America.	0.0
The PAD called for the resignation of the governments of Thaksin Shinawatra, Samak Sundaravej and Somchai Wongsawat, whom the PAD accused of being proxies for Thaksin.	Background DES uses a 56 - bit key, meaning that there are 256 possible keys under which a message can be encrypted.	0.0
However travel through very remote areas, on isolated tracks, requires advance planning and a suitable, reliable vehicle (usually a four wheel drive).	Furthermore it is the episcopal see of the Diocese of Växjö.	0.0
While at Kahn he was chief architect for the Fisher Building in 1928.	Sportswear (or Active attire) is clothing, including footwear, worn for sport or exercise.	0.0
He excuses himself because he has to leave for rehearsal, and he and Dr. Schön leave.	Freetown is home to Fourah Bay College, the oldest university in West Africa, founded in 1827.	0.0
Britpop emerged from the British independent music scene of the early 1990s and was characterised by bands influenced by British guitar pop music of the 1960s and 1970s.	The Administrators of the Northern Territory and Norfolk Island are, by contrast, appointed by the Governor-General.	0.0
This was absorbed into battalions being formed for XI International Brigade.	Drammen is also the main harbor for car and fruit import in Norway.	0.0
The Sheppard line currently has fewer users than the other two subway lines, and shorter trains are run.	Bonham Carter made her film debut in the K. M. Peyton film, A Pattern of Roses, before appearing in her first leading role in Lady Jane.	0.0
It has a capacity of 98,772, making it the largest stadium in Europe, and the eleventh largest in the world.	In mathematics, a Riemann sum is a method for approximating the total area underneath a curve on a graph, otherwise known as an integral.	0.0
In December, 1967, Ten Boom was honored as one of the Righteous Among the Nations by the State of Israel.	He skated his last with the show in 2007.	0.0
Some articles are quite lengthy and rich in content while others are shorter (possibly stubs) and of lesser quality.	He is called Saint James the Greater to distinguish him from James, son of Alphaeus, who is also known as James the Less.	0.0
About 95 species are currently accepted.	It accelerated northeast parallel to the East Coast and became extratropical on July 23 near Nova Scotia.	0.0
"Eugowra is said to be named after the Indigenous Australian word meaning ""The place where the sand washes down the hill""."	This took the republic by surprise, especially because the SPD was below 25% in polls at the time.	0.0
"Terms such as ""undies"" for underwear and ""movie"" for ""moving picture"" are oft-heard terms in English."	The surname Christian is an Anglicization of the Manx name McCrystyn.	0.0
Jurisdiction draws its substance from public international law, conflict of laws, constitutional law and the powers of the executive and legislative branches of government to allocate resources to best serve the needs of its native society.	Since Poland's accession to the European Union, a significant number of Poles have emigrated to Western European countries such as the United Kingdom, Germany and Ireland in search of work.	0.0
He followed this with several other pieces about Hiawatha: The Death of Minnehaha, Overture to The Song of Hiawatha and Hiawatha's Departure.	The PKCS # 1 standard also incorporates processing schemes designed to provide additional security for RSA signatures, e. g., the Probabilistic Signature Scheme for RSA (RSA-PSS).	0.0
The capital of the state is Aracaju (pop.	Do not excuse what you did with what others did.	0.0
Despite this, Farrenc was paid less than her male counterparts for nearly a decade.	In Augustan Rome, Quirinus was also an epithet of Janus, as Janus Quirinus.	0.0
Gumbasia was created in a style Vorkapich taught called Kinesthetic Film Principles.	He has also recorded five albums as a solo artist, debuting with Leading Off in 1994.	0.0
The lawyer, Brandon (Waise Lee), became his idol, and MK Sun grew up to be a lawyer.	Some of the technologies have been adapted to social networking services and ISPs.	0.0
ISBN 1-876429-14-3 is an historic township located near Cowra in the central west of New South Wales, Australia in Cabonne Shire.	"Benjamin Jeremy ""Ben"" Stein (born November 25, 1944) is an American actor, writer, and commentator on political and economic issues."	0.0
Military career Donaldson enlisted in the Australian Army on 18 June 2002.	It is the largest known non-spherical moon in the solar system.	0.0
Prospectors from California, Europe and China were also digging along the Peel River and up the mountain slopes.	When no one showed any interest, Cave took on the task by himself.	0.0
Before the advent of the pocket calculator, it was the most commonly used calculation tool in science and engineering.	David William Donald Cameron (born 9 October 1966) is the leader of the Conservative Party and Leader of Her Majesty's Loyal Opposition in the United Kingdom.	0.0
The Kindle 2 features 16-level grayscale display, improved battery life, 20 percent faster page-refreshing, a text-to-speech option to read the text aloud, and overall thickness reduced from 0.8 to 0.36 inches (9.1 millimeters).	The staff has since expanded to more than thirty people and two continents with an office in Lahore, Pakistan.	0.0
Yoghurt or yogurt is a dairy product produced by bacterial fermentation of milk.	Uses Tar was also used as seal for roofing shingles and to seal the hulls of ships and boats.	0.0
Seventy-five defencemen are in the Hall of Fame, more than any other current position, while only 35 goaltenders have been inducted.	On September 17, 2004, Whedon announced on the movie's official website that shooting had been completed.	0.0
Alternative views on the subject have been proposed throughout the centuries (see below), but all were rejected by mainstream Christian bodies.	"Although she had previously spoken in fantasies and dream sequences, Maggie's first word spoken in the normal continuity of the series occurred in ""Lisa's First Word"", when she was voiced by Elizabeth Taylor."	0.0
The album, however, was banned from many record stores nationwide.	In Week 16, quarterback Matt Leinart went down with a shoulder injury against the 49ers, forcing Warner to see his first action since Week 4.	0.0
The legs are wide at the top, and narrow at the ankle.	CISC and RISC The terms RISC and CISC have become less meaningful with the continued evolution of both CISC and RISC designs and implementations.	0.0
In late 2004, Suleman made headlines by cutting Howard Stern's radio show from four Citadel stations, citing Stern's frequent discussions regarding his upcoming move to Sirius Satellite Radio.	Psychedelic music is a term that refers to a broad set of popular music styles, genres and scenes, that may include psychedelic rock, psychedelic folk, psychedelic pop, psychedelic soul, psychedelic ambient, psychedelic trance, and others.	0.0
"The company opened twice as many Canadian outlets as McDonald's ""Wendy's confirms Tim Hortons IPO by March"", Ottawa Business Journal, December 1, 2005, and system-wide sales also surpassed those of McDonald's Canadian operations as of 2002."	Gun dogs Gun dogs are used primarily by small game hunters using shotguns.	0.0
"Plot Captain Caleb Holt (Kirk Cameron) is a firefighter in Albany, Georgia and firmly keeps the cardinal rule of all firemen, ""Never leave your partner behind""."	It overlies the North Pole, touching North America in the Western hemisphere and Scandinavia and Asia in the Eastern hemisphere.	0.0
He won the presidential election held on 2 March 2008 with 71.25% of the popular vote.	In the 1920s and early 1930s he frequently worked with the London Symphony Orchestra.	0.0
The plant is considered a living fossil.	Some are arboreal, with long balancing tails and other adaptations for climbing, while others are semiaquatic, with webbed feet and small external ears.	0.0
In 1990, she was the only female entertainer allowed to perform in Saudi Arabia.	She is an acclaimed interpreter of the works of Mozart, Beethoven, Schubert, Chopin, Debussy and Schoenberg.	0.0
Orchestration Stravinsky first conceived of writing the ballet in 1913.	Some of the computer models suggested the weakening tropical storm could be absorbed by a developing low to the west, which a few days later became Hurricane Epsilon.	0.0
Protests across the nation were suppressed.	In particular, Linux distributions Debian and Ubuntu have provided ready-to-use openclipart packages for easy download and install from their online software repositories.	0.0
Offenbach's numerous operettas, such as Orpheus in the Underworld, and La belle Hélène, were extremely popular in both France and the English-speaking world during the 1850s and 1860s.	Approximately 1,100 mud volcanoes have been identified on land and in shallow water.	0.0
Roof tiles dating back to the Tang Dynasty with this symbol have been found west of the ancient city of Chang'an (modern-day Xian).	Of the seven candidates, he topped each of the four straw polls conducted by the United Nations Security Council: on 24 July, 14 September, 28 September, and 2 October.	0.0
Jeanne Marie-Madeleine Demessieux (February 13, 1921 November 11, 1968), was a French organist, pianist, composer, and pedagogue.	It has a composition similar to 1 Ceres: a darkly colored surface that is heavily space weathered with the composition of primitive organic compounds, including tholins.	0.0
By most accounts, the instrument was nearly impossible to control.	The last Mummy film grossed over $102 million in the USA and over $400 million worldwide.	0.0
Santa Maria Maggiore (St. Mary the Greater), the earliest extant church in Assisi.	It fared much better than The Rocker, opening at # 2.	0.0
Characteristics Radar observations indicate a fairly pure iron-nickel composition.	By September 1 a cyclonic circulation with a diameter of 690 mile (1115 km) was evident on satellite imagery, well to the southeast of the Cape Verde Islands, and several hurricane forecast models anticipated development and strengthening.	0.0
Railway Gazette International is a monthly business journal covering the railway, metro, light rail and tram industries worldwide.	Lisa Gerrard (born April 12, 1961) is an Australian musician, singer and composer who rose to prominence as part of the music group Dead Can Dance with former music partner Brendan Perry.	0.0
He was appointed Companion of Honour (CH) in 1988.	Overview It was contested by 12 teams, and SK Admira Wien won the championship.	0.0
Loèche harbours the installations of Onyx, the Swiss interception system for electronic intelligence gathering.	Under Adams, Sinn Féin appeared to move away from being a political voice of the Provisional IRA to becoming a professionally organised political party in both Northern Ireland and the Republic of Ireland.	0.0
A matchbook is a small cardboard folder (matchcover) enclosing a quantity of matches and having a coarse striking surface on the exterior.	In 1828, Coenraad Johannes van Houten developed the first cocoa powder producing machine in the Netherlands.	0.0
She was among the first doctors to object to cigarette smoking around children, and drug use in pregnant women.	The VC was introduced on 29 January 1856 by Queen Victoria to reward acts of valour during the Crimean War.	0.0
Defiantly, she vowed to never renounce the Commune, and dared the judges to sentence her to death.	Harry Potter is a series of seven fantasy novels written by British author J. K. Rowling.	0.0
OEL manga series Graystripe's Trilogy There is a three volume original English-language manga series following Graystripe, between the time that he was taken by Twolegs in Dawn until he returned to ThunderClan in The Sight.	"Earthsea is a fictional realm originally created by Ursula K. Le Guin for her short story ""The Word of Unbinding"", published in 1964, that became more famous in her novel A Wizard of Earthsea, first published in 1968."	0.0
Samovar & Porter (1994), p. 84 Syrians did not congregate in urban enclaves; many of the immigrants who had worked as peddlers were able to interact with Americans on a daily basis.	Though his father wanted him to continue his training as a goldsmith, he showed such a precocious talent in drawing that he started as an apprentice to Michael Wolgemut at the age of fifteen in 1486.	0.0
He was also famous for his prints, book covers, posters, and garden metalwork furniture.	August 22 Hurricane Bill weakens to a Category 1 hurricane.	0.0
During childhood she suffered from collapsed lungs twice, she had pneumonia 4-5 times a year, a ruptured appendix, and had a tonsillar cyst.	This was followed by the establishment of the Grey League (Grauer Bund), sometimes called Oberbund, in 1395 in the Upper Rhine valley.	0.0
Dr. David Lindenmeyer (Australian National University) has argued that the need for nest boxes indicates that logging practices are not ecologically sustainable, for conserving hollow-dependent species like Leadbeater's possum.	Traces of the amphitheatre can still be seen in the Piazza dell'Anfiteatro.	0.0
The Montreal Canadiens are a professional ice hockey team based in Montreal, Quebec, Canada.	"Etymology The first person who used the term ""Seidenstraße"" (literally ""Silk Road"") was the German geographer Ferdinand von Richthofen in 1877."	0.0
Small value inductors can also be built on integrated circuits using the same processes that are used to make transistors.	Usucha creates a lighter and slightly more bitter tea.	0.0
The term gribble was originally assigned to the wood-boring species, especially the first species described from Norway by Rathke in 1799, Limnoria lignorum.	"Eleven departments and Institutes focused on ""Stimulating Global Evangelism"" with 25 - 40 staff, carry out the work."	0.0
The wounds inflicted by a club are generally known as bludgeoning or blunt-force trauma injuries.	Castlevania III: Dracula's Curse is the third game in the series' canon, featuring Simon Belmont's ancestor, Trevor Belmont.	0.0
Thereafter the county's administration was conducted at Duns or Lauder until Greenlaw became the county town in 1596.	Proper saddle care can extend the useful life of a saddle, often for decades.	0.0
No skater has yet accomplished a quadruple Axel in competition.	"Etymology and usage Lyric derives from the Greek word lyrikos, meaning ""singing to the lyre""."	0.0
From the telephone exchange, the Port Jackson District Commandant could communicate with all military installations on the harbour.	Normally, a state delegation is headed by the respective minister-president.	0.0
However, even to those who enter the prayer hall of a mosque without the intention of praying, there are still rules that apply.	Stegosaurian teeth were small, triangular and flat wear facets show that they did grind their food.	0.0
It is described as pointed in the face and about the size of a rabbit.	It was not detected again until the Hubble Space Telescope observed it in 1997.	0.0
Computer performance is characterized by the amount of useful work accomplished by a computer system compared to the time and resources used.	In medieval England, the territories of Lancashire and Cornwall were made duchies, with certain powers accruing to their dukes.	0.0
Some of the largest reservoirs in the world can be found along the Volga.	The term was coined by merging the name for the two orders, Cetacea and Artiodactyla, into a single word.	0.0
The crosier symbolises the monasteries of the region.	Rated an F0 tornado, it touched down near Brunswick, Georgia were it snapped trees and caused moderate roof damage along its 2 mi (3.2 km) path.	0.0
Human skin hues can range from very dark brown to very pale pink.	Some commentators notice a connection between the character Michael K and the protagonist Josef K. in The Trial by Franz Kafka.	0.0
Bankers from ShoreBank, a community development bank in Chicago, helped Yunus with the official incorporation of the bank under a grant from the Ford Foundation.	An oratorio is a large musical composition including an orchestra, a choir, and soloists.	0.0
Bremer reported plans to put Saddam on trial, but claimed that the details of such a trial had not yet been determined.	The Hainich has become the 13th national park of Germany in 1997.	0.0
Representatives of the Professional Hockey Writers' Association vote for the All-Star Team at the end of the regular season.	Tonnerre Yaoundé are a football (soccer) club based in Yaoundé, Cameroon.	0.0
Tajikistan, Turkmenistan and Uzbekistan border Afghanistan to the north, Iran to the west, Pakistan to the south and the People's Republic of China to the east.	This is probably one of the sources of Sarasvati / Benzaiten's close association with snakes and dragons in Japan.	0.0
Nupedia was founded on March 9, 2000, under the ownership of Bomis, Inc, a web portal company.	By that time the asymmetrical nose had been cut off and discarded, possibly for additional air flow to the radiator for the car's use in and around the carnivals.	0.0
Notable features of the design include key-dependent S-boxes and a highly complex key schedule.	A few years later, in 1840, General Zorawar Singh invaded Baltistan, captured the Raja of Skardu, who had sided with the Ladakhis, and annexed his country.	0.0
Iain Grieve (born 19 February, 1987 in Jwaneng, Botswana) is a rugby union back-rower for Bristol Rugby in the Guinness Premiership.	In geology, when an igneous intrusion cuts across a formation of sedimentary rock, it can be determined that the igneous intrusion is younger than the sedimentary rock.	0.0
Other nearby settlements include Pont-Bellanger and Beaumesnil.	High gusts were reported throughout Texas, with a maximum gust of reported on the Coast Guard cutter Buttonwood (WLB-306) stationed at the northeastern tip of Galveston Island.	0.0
The quark model was independently proposed by physicists Murray Gell-Mann and George Zweig in 1964.	A condiment is a relish, sauce, or seasoning added to food to impart a particular flavour or to complement the dish.	0.0
The fourth ring is decorated with golden garlands and was added in 1938 39 when the column was moved to its present location.	This is a list of German Presidents since 1919 by longevity.	0.0
West Berlin had its own postal administration, separate from West Germany's, which issued its own postage stamps until 1990.	"The black core of pencils is still referred to as ""lead"", even though it never contained the element lead."	0.0
The Primavera is a painting by the Italian Renaissance painter Sandro Botticelli, c. 1482.	Occultations by Hermione have been successfully observed three times so far, the last time in February, 2004.	0.0
New South Wales's largest city and capital is Sydney.	Contact between visiting seamen and prisoners was barred.	0.0
The polymer is most often epoxy, but other polymers, such as polyester, vinyl ester or nylon, are also sometimes used.	It is currently used mostly for football matches and is the home of Santos Football Club.	0.0
The name survives as a brand for a related spin-off digital television channel, digital radio station, and website which have survived the demise of the printed magazine.	Introduction This unstaffed station on the Qingzang railway opened for service on July 1, 2006.	0.0
At four-and-a-half years old he was left to fend for himself on the streets of northern Italy for the next four years, living in various orphanages and roving through towns with groups of other homeless children.	As the storm began to rapidly intensify, the warning was further modified to a hurricane warning.	0.0
Stands were eventually added behind each set of goals during the 1980s and 1990s as the ground began to be modernised.	They were responsible for ensuring that people had many children and that the land produced plentiful crops.	0.0
A town may be correctly described as a market town or as having market rights even if it no longer holds a market, provided the right to do so still exists.	In the manga, Blaine is a former Team Rocket Scientist who had combined the DNA of Mew with his own DNA, creating Mewtwo.	0.0
A bastion on the eastern approaches was built later.	The common soft corals on the Great Barrier Reef belong to 36 genera.	0.0
Events Europe July 29 — Battle of Stiklestad (Norway): Olav Haraldsson loses to his pagan vassals and is killed in the battle.	After attaining tropical storm status, the maximum sustained winds fluctuated for three days between 40 mph (65 km / h) and 50 mph (85 km / h).	0.0
Others have theorized that Tresca was eliminated by the NKVD as retribution for criticism of the Stalin regime of the Soviet Union.	Gramophone Archive By age 15, he had already given concerts worldwide.	0.0
This resulted in both Montenegro and Serbia becoming independent countries.	On August 15, convection organized into bands, and as its winds approached hurricane strength, an eye developed within the storm.	0.0
Use HTML and CSS markup sparingly and only with good reason.	The foundations of quantum mechanics were established during the first half of the twentieth century by Werner Heisenberg, Max Planck, Louis de Broglie, Albert Einstein, Niels Bohr, Erwin Schrödinger, Max Born, John von Neumann, Paul Dirac, Wolfgang Pauli, David Hilbert, and others.	0.0
Schuschnigg immediately responded publicly that reports of riots were false.	National symbols intend to unite people by creating visual, verbal, or iconic representations of the national people, values, goals, or history.	0.0
Addiscombe is a suburb in the London Borough of Croydon, England.	An even larger terminal to be sited nearby is also being promoted.	0.0
Depending on the context, another closely-related meaning of constituent is that of a citizen residing in the area governed, represented, or otherwise served by a politician; sometimes this is restricted to citizens who elected the politician.	This method can result in infection, and injury to internal organs (for example pulling out the intestines), resulting in death.	0.0
Prunk is a member of Institute of European History in Mainz, and a senior fellow of the Center for European Integration Studies in Bonn.	ISO 3166 - 1 is part of the ISO 3166 standard published by the International Organization for Standardization (ISO), and defines codes for the names of countries, dependent territories, and special areas of geographical interest.	0.0
Stallone also had a cameo appearance in the 2003 French film Taxi 3 as a passenger.	"She subsequently recorded ""Kanashiki kuchibue"", which was featured on a radio program and was a national hit."	0.0
"Instead, the crew fashioned a trailer with a cantilevered arm attached to the ""hovercraft"" and shot the scene while riding up Templin Highway north of Santa Clarita."	Postal systems often have functions other than sending letters.	0.0
The conference papers were published the next year in a bookMicroeconomic Foundations of Employment and Inflation Theory by Phelps et al.	In the fall of 2006, Cavergno and Bignasco were incorporated into the municipality, despite an attempt by Bignasco to resist the incorporation in the courts.	0.0
Wario Land The Wario Land series is a platforming series that started with Wario Land: Super Mario Land 3, a spin-off of the Super Mario Land series.	"In his book ""Russia at War 1941 to 1945"", Alexander Werth reported that while visiting Gdansk / Danzig in 1945 shortly after its liberation by the Red Army, he saw an experimental factory outside the city for making soap from human corpses."	0.0
Frédéric Chopin's Opus 57 is a berceuse for solo piano.	Ararat is considered the national symbol of Armenia and thus is of principal importance to the coat of arms.	0.0
These attacks may have been psychological in origin rather than physical.	This tree is a frequent destination for pilgrims, being the most important of the four main Buddhist pilgrimage sites.	0.0
"A historian has stated that ""it was quinine's efficacy that gave colonists fresh opportunities to swarm into the Gold Coast, Nigeria and other parts of west Africa""."	To make space for more agricultural land, large areas of forest were cut down, taking away its habitat.	0.0
Furthermore, spectroscopic studies have shown evidence of hydrated minerals and silicates, which indicate rather a stony surface composition.	This belief most likely stemmed from the fact that it is possible to have the Furby say certain pre-programmed words or phrases more often by petting it whenever it said these words.	0.0
She became the authoritative editor of her husband's works for Breitkopf und Härtel.	Ornamental plants are typically grown in the flower garden or as house plants.	0.0
Mercury is similar in appearance to the Moon: it is heavily cratered with regions of smooth plains, has no natural satellites and no substantial atmosphere.	However, the term font is also often used as a metonym for typeface.	0.0
Geography The town lies in the Limmat valley between Baden and Zürich.	His work driving forward the development of products that are both functional and elegant has earned him a devoted following.	0.0
These ideally provide excellent habitat for chinkara, hog deer and blue bull.	Saint-Victoret is a commune in the Bouches-du-Rhône department in the Provence-Alpes-Côte d'Azur region in southern France.	0.0
After the Sena dynasty, Dhaka was successively ruled by the Turkish and Afghan governors descending from the Delhi Sultanate before the arrival of the Mughals in 1608.	He was married to Greek duchess Sofia.	0.0
The Prime Minister stays in office only as long as he or she retains the support of the lower house.	A dogfight, or dog fight, is aerial combat between fighter aircraft.	0.0
For Rowling, this scene is important because it shows Harry's bravery, and by retrieving Cedric's corpse, he demonstrates selflessness and compassion.	Cruiserweight Open for the WWE Cruiserweight Championship 10: 28 7 Goldberg defeated Brock Lesnar.	0.0
On June 1, 1972, he and fellow RAF members Jan-Carl Raspe and Holger Meins were apprehended after a lengthy shootout in Frankfurt.	The first application of this idea in the United States was pioneered by Dr. William Mosenthal, a surgeon at the Dartmouth-Hitchcock Medical Center.	0.0
Together they formed New Music Manchester, a group committed to contemporary music.	Cameron Bright as Jimmy / Leech: A mutant boy whose power neutralizes the powers of nearby mutants.	0.0
The compact and intense hurricane caused extreme damage in the upper Florida Keys, as a storm surge of approximately 18 to 20 feet affected the region.	Description In a multiprocessor system executing a single set of instructions (SIMD), data parallelism is achieved when each processor performs the same task on different pieces of distributed data.	0.0
It is now the site of Meher Baba's samadhi (tomb-shrine) as well as facilities and accommodations for pilgrims.	The Sahara Pump Theory is a hypothesis that explains how flora and fauna left Africa to penetrate the Middle East and then Europe and Asia.	0.0
The collapsed dome of the main church has been restored entirely.	Within the hCard is a Geo microformat, which additionally makes the coordinates (latitude & longitude) parsable, so that they can be, say, looked up on a map, or downloaded to a GPS unit.	0.0
In 2005, Meissner became the second American woman to land the triple Axel jump in national competition.	The novel received the 1961 Pulitzer Prize for Fiction.	0.0
Salem is a city in Essex County, Massachusetts, United States.	However, in criminal cases in which the sentence is expected to exceed two years, the professional judge is assisted by two lay judges with equal rights as the professional judge (Schöffengericht).	0.0
Forty-nine species of pipefish and nine species of seahorse have been recorded.	Later that year, the band released their debut album, Fresh Fruit for Rotting Vegetables.	0.0
Saint Martin is a tropical island in the northeast Caribbean, approximately 300 km (186 miles) east of Puerto Rico.	He was brought in as a guitarist following Josh Brainard's departure and is the last member of the band's current line-up to have joined.	0.0
Therefore, these PDFs can not be distributed without further manipulation if they contain images.	The term Dakshinachara (Right-Hand Path) is used to refer to Tantric sects that do not engage in these heterodox practices.	0.0
In April 1862, Ben was arrested on the orders of Police Inspector Sir Frederick Pottinger for participating in an armed robbery whilst in the company of Frank Gardiner.	History Arch Mineral Corporation was founded in 1969 as a partnership between Ashland Oil (now Ashland, Inc.) and the Hunt family of Dallas, Texas.	0.0
Heavy rain fell across portions of Britain on October 5, causing localized accumulation of flood waters.	Strength of the bond The atoms in metals have a strong attractive force between them.	0.0
Version 2009.1 provides a USB installer to create a Live USB, where the user's configuration and personal data can be saved if desired.	Before Snow White, the Disney studio had been primarily involved in the production of animated short subjects in the Mickey Mouse and Silly Symphonies series.	0.0
In approximate relation to the parties' respective strength in the Federal Assembly, the seats were distributed as follows: Free Democratic Party (FDP): 2 members, Christian Democratic People's Party (CVP): 2 members, Social Democratic Party (SP): 2 members, and Swiss People's Party (SVP): 1 member.	Tyler attended the Congressional School of Virginia, Breakwater School and Waynflete School in Portland, Maine, before returning to New York City with her mother at the age of 12.	0.0
A fee is the price one pays as remuneration for services, especially the honorarium paid to a doctor, lawyer, consultant, or other member of a learned profession.	Some define the hadopelagic as waters below 6,000 m (19,685 ft), whether in a trench or not.	0.0
Ohio State's library system encompasses twenty-one libraries located on its Columbus campus.	Though he was raised in a devout Lutheran household, Bergman later stated that he lost his faith at age eight years, and only came to terms with this fact while making Winter Light.	0.0
In other developments, both Iceland and Greenland accepted the overlordship of Norway, but Scotland was able to repulse a Norse invasion and broker a favorable peace settlement.	She has a three-octave vocal range Accessed August 5, 2008 and a distinctively rapid vibrato.	0.0
"The singles from the album included ""By the Way"", ""The Zephyr Song"", ""Ca n't Stop"", ""Dosed"" and ""Universally Speaking""."	Prometheus acts as a shepherd satellite for the inner edge of Saturn's F Ring.	0.0
In April 2000, MINIX became free / open source software under a permissive free software licence, but by this time other operating systems had surpassed its capabilities, and it remained primarily an operating system for students and hobbyists.	It was directed by Australian Baz Luhrmann and stars Leonardo DiCaprio and Claire Danes in the eponymous roles.	0.0
The body color varies from medium brown to gold-ish to beige-white; and occasionally, is marked with dark brown spots, especially on the limbs.	The Convent has been the official residence of the Governor of Gibraltar since 1728.	0.0
The Britannica was primarily a Scottish enterprise, as symbolised by its thistle logo, the floral emblem of Scotland.	Many students choose a faculty committee whose members represent their own interdisciplinary interests.	0.0
The area covered by the warning issued on September 22 was extended southwards as Jose intensified, before being canceled soon after landfall on September 23.	Given these assumptions it is possible to calculate how often they can fail and to arrange the array to make data loss arbitrarily improbable.	0.0
In August 2003, the San Diego Union Tribune alleged that U.S. Marine pilots and their commanders confirmed the use of Mark 77 firebombs on Iraqi Republican Guards during the initial stages of combat.	Various objection were raised to this scheme, and the Corporation refused to allow tram lines to be laid in the High Street and Above Bar.	0.0
The latter provided audiences with the sort of information later provided by intertitles, and can help historians imagine what the film may have been like.	The term is generally applied to all of Morocco, Algeria, and Tunisia, but in older Arabic usage pertained only to the area of the three countries between the high ranges of the Atlas Mountains and the Mediterranean Sea.	0.0
That is because real estate, businesses and other assets in the underground economies of the Third World can not be used as collateral to raise capital to finance industrial and commercial expansion.	Source Mage GNU / Linux A source code-based distribution, descended from Sorcerer.	0.0
He bolted from Sydney Cove several times before being shot dead in 1796.	Convection increased on August 11, and by August 12 the interaction between a tropical wave and an upper-level low in the area resulted in a large area of disorganized thunderstorms extending from the western Caribbean Sea into the central Bahamas.	0.0
Ned and Dan advanced to the police camp, ordering them to surrender.	The color has been speculated to be due to organic compounds on its surface.	0.0
"Before the second game got underway, the press agreed that the ""midget-in-a-cake"" appearance had not been up to Veeck's usual promotional standard."	In the case of asteroids, so many have been discovered that many will never be named by their discoverers.	0.0
"In a short video promoting the charity Equality Now Joss Whedon confirmed that ""Fray is not done, Fray is coming back."	"In The Tomb of the Cybermen (1967), veins and brains were visible through the domed head of the Cyberman Controller and similarly, in Attack of the Cybermen (1985) and ""The Age of Steel"" (2006), the Cyber-Controller's brain is visible through the dome."	0.0
A mutant is a type of fictional character that appears in comic books published by marvel comics.	As a C-type, it is probably composed of carbonaceous materials.	0.0
The SAT Reasoning Test (formerly Scholastic Aptitude Test and Scholastic Assessment Test) is a standardized test for college admissions in the United States.	Kurt Georg Kiesinger (6 April 1904 9 March 1988) was a conservative German politician and Chancellor of West Germany from 1 December 1966 until 21 October 1969.	0.0
Civil unrest in northern Italy spawns the medieval musical form of Geisslerlieder, penitential songs sung by wandering bands of Flagellants.	Ólafur's second marriage was to Israeli-born Dorrit Moussaieff, to whom he became engaged in May 2000.	0.0
Some reports read that various factors increase the likelihood of both paralysis and hallucinations.	It is most commonly used in cooking and pottery.	0.0
His sentence was transportation to Australia for seven years.	Prevalence In the United States, according to Business magazine, an estimated 15 million functionally illiterate adults held jobs at the beginning of the 21st century.	0.0
"Waugh writes that Charles had been ""in search of love in those days"" when he first met Sebastian, finding ""that low door in the wall... which opened on an enclosed and enchanted garden"", a metaphor that informs the work on a number of levels."	Publications Scope and preparation of the reports The IPCC reports are a compendium of peer reviewed and published science.	0.0
Her notorious friendship with the Russian mystic Grigori Rasputin was also an important factor in her life.	If more energy is available, other elements will be ionized and green and blue nebulae become possible.	0.0
The term dorsal refers to anatomical structures that are either situated toward or grow off that side of an animal.	They discover a wardrobe in Professor Digory Kirke's house that leads to the magical land of Narnia.	0.0
"The term ""protein"" itself was coined by Berzelius, after Mulder observed that all proteins seemed to have the same empirical formula and might be composed of a single type of (very large) molecule."	Like most brooms, it has apparently leafless stems that in spring and summer are covered in profuse golden-yellow flowers.	0.0
After the Jerilderie raid, the gang laid low for 16 months evading capture.	Thyme retains its flavour on drying better than many other herbs.	0.0
Barneville-la-Bertran is a commune in the Calvados department in the Basse-Normandie region in northwestern France.	Paul Jackson was installed as a producer.	0.0
Color ranges from orange to pale yellow.	Victoria Island (or Kitlineq) is an island in the Canadian Arctic Archipelago and straddles the boundary between Nunavut and the Northwest Territories of Canada.	0.0
In 1963 an extension was added, curving north from Union station, below University Avenue and Queen's Park to near Bloor Street, where it turned west to terminate at St. George and Bloor Streets.	Meteorological history A cut-off extratropical cyclone over the central north Pacific moved over an area of ocean with sea surface temperatures as high as 2 ° C above normal for two days.	0.0
Before 1980, a section of the Commonwealth Railways Central Australian line passed along the western side of the Simpson Desert.	The series attempted to create a setting of a gritty, realistic police station similar to that of NYPD Blue, but differed by focusing on the uniformed police officers rather than the detectives.	0.0
It is located on an old portage trail which led west through the mountains to Unalakleet.	The rotational period of the interior of Uranus is 17 hours, 14 minutes.	0.0
People with cardiomyopathy are often at risk of arrhythmia or sudden cardiac death or both.	Springville is a city in Linn County, Iowa, United States.	0.0
As the largest sub-region in Mesoamerica, it encompassed a vast and varied landscape, from the mountainous regions of the Sierra Madre to the semi-arid plains of northern Yucatán.	His character and early life He was considered a modest, prayerful person, he was thought of as honest and pure by his classmates.	0.0
Google subsequently made the comic available on Google Books and their site and mentioned it on its official blog along with an explanation for the early release.	This victory brought him 2000 pesetas.	0.0
Anyone may register a pedigree with the college, where they are carefully internally audited and require official proofs before being altered.	One candidate met with success: Alfred Waterson who became a Member of Parliament for the Kettering seat.	0.0
The book, Political Economy, was published in 1985, but had limited classroom adoption.	In 1934, Dupré succeeded Charles-Marie Widor as titular organist at St. Sulpice in Paris, a post he held until his death in 1971.	0.0
He toured with the IPO in the spring of 1990 for their first-ever performance in the Soviet Union, with concerts in Moscow and Leningrad, and toured with the IPO again in 1994, performing in China and India.	"Those who are born in the state are known as ""Capixabas"", although the precise word is ""espiritossantenses""."	0.0
Napoleonic Wars: Austrian General Mack surrenders his army to the Grand Army of Napoleon at Ulm, reaping Napoleon over 30,000 prisoners and inflicting 10,000 casualties on the losers.	Because of the lack of physical characteristics supporting this group, it is very possible that the subfamily as it is currently recognized is subject to enlargement.	0.0
It has long been the economic centre of northern Nigeria, and a centre for the production and export of groundnuts.	They often simply groan in disapproval in situations where a human toddler would throw a tantrum.	0.0
A majority of South Indians speak one of the five Dravidian languages — Kannada, Malayalam, Tamil, Telugu and Tulu.	Also, it hybridizes with some other wattles, notably the rare and endangered Sydney Basin species Acacia pubescens.	0.0
Meteora earned the band multiple awards and honors.	The orchestra is associated with the triennial Gustav Mahler Conducting Prize.	0.0
After a brief stand-off, the WWF cavalry turned around and attacked Kane and Jericho.	Baduhennna is solely attested by Tacitus' Annals where Tacitus records that a grove in Frisia was dedicated to her, and that near this grove 900 Roman prisoners were killed in 28 CE.	0.0
Most of the songs were written by Richard M. Sherman and Robert B. Sherman.	In February 2007, Essjay was found to have made false claims about his academic qualifications and professional experiences on his Wikipedia user page and to journalist Stacy Schiff during an interview for The New YorkerSchiff, Stacey.	0.0
In the 5th century Slavs started to move into the area.	References External links Official site Ibanez guitars and bass museum - Ibanez instruments database, resources, user reviews, pictures History of Hoshino Gakki Co., Ltd.	0.0
From 1900 to 1920 many new facilities were constructed on campus, including facilities for the dental and pharmacy programs, a chemistry building, a building for the natural sciences, Hill Auditorium, large hospital and library complexes, and two residence halls.	From 1938, newer SS uniforms featured the shoulder boards of a German Oberst in addition to the oak leaf collar patches.	0.0
Winchester is a city in Scott County, Illinois, United States.	Dar es Salaam was retained as the territory's administrative and commercial centre.	0.0
Name Arzashkun seems to be the Assyrian form of an Armenian name ending in -ka formed from a proper name Arzash, which recalls the name Arsene, Arsissa, applied by the ancients to part of Lake Van.	Primeval redwood forests, coastal mangrove stands, sphagnum bogs, desert soil crusts, roadside weed patches, wheat fields, cultivated gardens and lawns; all are encompassed by the term vegetation.	0.0
Out of 16,421 participants in the national casting, she was chosen among the 15 candidates to appear on the TV show.	The first parallax measurement of the distance to Alpha Centauri is published by Thomas Henderson.	0.0
Its episodes were broadcast on the ABC network from its debut on September 21, 1993 to March 1, 2005.	Demographics The population of the city is now largely made up of the descendants of laborers who were hired for labor from India in the 19th century.	0.0
The latter device can then be designed and used in less stringent environments.	Some computers can boot up from flash drives.	0.0
Gimnasia hired first famed Colombian trainer Francisco Maturana, and then Julio César Falcioni, but both had limited success.	All species have a distinctly bear-like gait, due to their front legs being longer than their back legs.	0.0
Brighton is a city in Washington County, Iowa, United States.	They can occur at any beach with breaking waves, including the world's oceans, seas, and large lakes such as the Great Lakes in the United States of America and Canada.	0.0
"Furthermore, she appeared in several music videos, including ""It Girl"" by John Oates and ""Just Lose It"" by Eminem."	The methodological ethos is identical, but there is a slight difference in the vocabulary, and Specialized is more international.	0.0
On June 24 1979 (the 750th anniversary of the village), Glinde received its town charter.	It takes place in an alternate history of the American frontier in the early 19th century, to some extent based on early American folklore and superstition.	0.0
"Pauline returned in the Game Boy remake of Donkey Kong in 1994, and later Mario vs. Donkey Kong 2: March of the Minis in 2006, although the character is now described as ""Mario's friend""."	Vikidia is an online encyclopedia wiki designed with Mediawiki software.	0.0
The vagina is remarkably elastic and stretches to many times its normal diameter during vaginal birth.	In modern days, joss sticks can be used for any purpose, such as to enhance the smell of a room, or to light fire crackers.	0.0
His real date of birth was never recorded, but it is believed to be a date between 1935 and 1939.	Thus, the first such storage facility in the US was implemented at Zoar Field, about forty miles south of Buffalo.	0.0
This quantitative measure indicates how much of a particular drug or other substance (inhibitor) is needed to inhibit a given biological process (or component of a process, i.e. an enzyme, cell, cell receptor or microorganism) by half.	Palembang is the capital city of South Sumatra Province of Indonesia.	0.0
Although the name suggests that they are located in the Bernese Oberland region of the canton of Bern, portions of the Bernese Alps are in the adjacent cantons of Valais, Lucerne, Obwalden, Fribourg and Vaud.	The ventricular muscle twitches randomly, rather than contracting in unison, and so the ventricles fail to pump blood into the arteries and into systemic circulation.	0.0
There he had one daughter, later baptized as Mary Ann Fisher Power, to Ann (e) Power.	A word consists of a root and a grammatical ending.	0.0
During an interview, Edward Gorey mentioned that Bawden was one of his favorite artists, lamenting the fact that not many people remembered or knew about this fine artist.	It was also during his tenure in Westminster that Pope John Paul II made a groundbreaking visit to England.	0.0
The string can vibrate in different modes just as a guitar string can produce different notes, and every mode appears as a different particle: electron, photon, gluon, etc.	The Terms of ServicePicasa: Terms of Service permit Google to use the uploaded photos to display on the website or via RSS feeds, and also for promoting Google services royalty-free.	0.0
Gable also earned an Academy Award nomination when he portrayed Fletcher Christian in 1935's Mutiny on the Bounty.	The contemporary status of the Mandaeans has prompted a number of American intellectuals and civil rights activists to call for their government to extend refugee status to the community.	0.0
